WWWWWWWWWW
W  AA B  W
W  HHHH  W
W  A     W
W AWCC  WW
W  ThW    
W    W   W
W YWXW   W
W    S   W
WWWWWWWWWW