WWWWWWWWWW
W F      W
W RHHHH  W
W     B  W
W  W XW  W
W    W  P 
W    W   W
W YXW    W
W   S P  W
WWWWWWWWWW